################################################################################################################################
#000000000000000000000000000000000000000000000000000000000000000000000000000000000000000000000000000000000000000000000000000000#
#000000000000000000000000000000000000000000000000000000000000000000000000000000000000000000000000000000000000000000000000000000#
#000000000000000000000000000000000000000000000000000000000000000000000000000000000000000000000000000000000000000000000000000000#
#000000000000000000000000000000000000000000000000000000000000000000000000000000000000000000000000000000000000000000000000000000#
#000000000000000000000000000000000000000000000000000000000000000000000000000000000000000000000000000000000000000000000000000000#
#000000000000000000000000000000000000000000000000000000000000000000000000000000000000000000000000000000000000000000000000000000#
#000000000000000000000000000000000000000000000000000000000000000000000000000000000000000000000000000000000000000000000000000000#
#000000000000000000000000000000000000000000000000000000000000000000000000000000000000000000000000000000000000000000000000000000#
#000000000000000000000000000000000000000000000000000000000000000000000000000000000000000000000000000000000000000000000000000000#
#000000000000000000000000000000000000000000000000000000000000000000000000000000000000000000000000000000000000000000000000000000#
#000000000000000000000000000000000000000000000000000000000000000000000000000000000000000000000000000000000000000000000000000000#
#000000000000000000000000000000000000000000000000000000000000000000000000000000000000000000000000000000000000000000000000000000#
#000000000000000000000000000000000000000000000000000000000000000000000000000000000000000000000000000000000000000000000000000000#
#000000000000000000000000000000000000000000000000000000000000000000000000000000000000000000000000000000000000000000000000000000#
#000000000000000000000000000000000000000000000000000000000000000000000000000000000000000000000000000000000000000000000000000000#
#000000000000000000000000000000000000000000000000000000000000000000000000000000000000000000000000000000000000000000000000000000#
#000000000000000000000000000000000000000000000000000000000000000000000000000000000000000000000000000000000000000000000000000000#
#000000000000000000000000000000000000000000000000000000000000000000000000000000000000000000000000000000000000000000000000000000#
#000000000000000000000000000000000000000000000000000000000000000000000000000000000000000000000000000000000000000000000000000000#
#000000000000000000000000000000000000000000000000000000000000000000000000000000000000000000000000000000000000000000000000000000#
#000000000000000000000000000000000000000000000000000000000000000000000000000000000000000000000000000000000000000000000000000000#
#000000000000000000000000000000000000000000000000000000000000000000000000000000000000000000000000000000000000000000000000000000#
#000000000000000000000000000000000000000000000000000000000000000000000000000000000000000000000000000000000000000000000000000000#
#000000000000000000000000000000000000000000000000000000000000000000000000000000000000000000000000000000000000000000000000000000#
#000000000000000000000000000000000000000000000000000000000000000000000000000000000000000000000000000000000000000000000000000000#
#000000000000000000000000000000000000000000000000000000000000000000000000000000000000000000000000000000000000000000000000000000#
#000000000000000000000000000000000000000000000000000000000000000000000000000000000000000000000000000000000000000000000000000000#
#000000000000000000000000000000000000000000000000000000000000000000000000000000000000000000000000000000000000000000000000000000#
#000000000000000000000000000000000000000000000000000000000000000000000000000000000000000000000000000000000000000000000000000000#
#000000000000000000000000000000000000000000000000000000000000000000000000000000000000000000000000000000000000000000000000000000#
################################################################################################################################

################################
#0000000000#000##00000000000000#
#0###0##0#000#0000###0######0###
#00000##0###0######00000000#0#0#
#0#0#00000000######0###0##00000#
###0######0###0000#000#0##0###0#
#00000000000000##000#0000000000#
################################

x:64 y:24

11111111111111111111111111111111
12222222222122211222222222222221
12111211212221222211121111112111
12222211211121111112222222212121
12121222222221111112111211222221
11121111112111222212221211211121
12222222222222211222122222222221
11111111111111111111111111111111

1, 1, 1, 1, 1, 1, 1, 1, 1, 1, 1, 1, 1, 1, 1, 1, 1, 1, 1, 1, 1, 1, 1, 1, 1, 1, 1, 1, 1, 1, 1, 1,
1, 2, 2, 2, 2, 2, 2, 2, 2, 2, 2, 1, 2, 2, 2, 1, 1, 2, 2, 2, 2, 2, 2, 2, 2, 2, 2, 2, 2, 2, 2, 1,
1, 2, 1, 1, 1, 2, 1, 1, 2, 1, 2, 2, 2, 1, 2, 2, 2, 2, 1, 1, 1, 2, 1, 1, 1, 1, 1, 1, 2, 1, 1, 1,
1, 2, 2, 2, 2, 2, 1, 1, 2, 1, 1, 1, 2, 1, 1, 1, 1, 1, 1, 2, 2, 2, 2, 2, 2, 2, 2, 1, 2, 1, 2, 1,
1, 2, 1, 2, 1, 2, 2, 2, 2, 2, 2, 2, 2, 1, 1, 1, 1, 1, 1, 2, 1, 1, 1, 2, 1, 1, 2, 2, 2, 2, 2, 1,
1, 1, 1, 2, 1, 1, 1, 1, 1, 1, 2, 1, 1, 1, 2, 2, 2, 2, 1, 2, 2, 2, 1, 2, 1, 1, 2, 1, 1, 1, 2, 1,
1, 2, 2, 2, 2, 2, 2, 2, 2, 2, 2, 2, 2, 2, 2, 1, 1, 2, 2, 2, 1, 2, 2, 2, 2, 2, 2, 2, 2, 2, 2, 1,
1, 1, 1, 1, 1, 1, 1, 1, 1, 1, 1, 1, 1, 1, 1, 1, 1, 1, 1, 1, 1, 1, 1, 1, 1, 1, 1, 1, 1, 1, 1, 1

################################################################################################################################
################################################################################################################################
################################################################################################################################
################################################################################################################################
####0000000000000000000000000000000000000000####000000000000########00000000000000000000000000000000000000000000000000000000####
####0000000000000000000000000000000000000000####000000000000########00000000000000000000000000000000000000000000000000000000####
####0000000000000000000000000000000000000000####000000000000########00000000000000000000000000000000000000000000000000000000####
####0000000000000000000000000000000000000000####000000000000########00000000000000000000000000000000000000000000000000000000####
####0000############0000########0000####000000000000####0000000000000000############0000########################0000############
####0000############0000########0000####000000000000####0000000000000000############0000########################0000############
####0000############0000########0000####000000000000####0000000000000000############0000########################0000############
####0000############0000########0000####000000000000####0000000000000000############0000########################0000############
####00000000000000000000########0000############0000########################00000000000000000000000000000000####0000####0000####
####00000000000000000000########0000############0000########################00000000000000000000000000000000####0000####0000####
####00000000000000000000########0000############0000########################00000000000000000000000000000000####0000####0000####
####00000000000000000000########0000############0000########################00000000000000000000000000000000####0000####0000####
####0000####0000####00000000000000000000000000000000########################0000############0000########00000000000000000000####
####0000####0000####00000000000000000000000000000000########################0000############0000########00000000000000000000####
####0000####0000####00000000000000000000000000000000########################0000############0000########00000000000000000000####
####0000####0000####00000000000000000000000000000000########################0000############0000########00000000000000000000####
############0000########################0000############0000000000000000####000000000000####0000########0000############0000####
############0000########################0000############0000000000000000####000000000000####0000########0000############0000####
############0000########################0000############0000000000000000####000000000000####0000########0000############0000####
############0000########################0000############0000000000000000####000000000000####0000########0000############0000####
####00000000000000000000000000000000000000000000000000000000########000000000000####0000000000000000000000000000000000000000####
####00000000000000000000000000000000000000000000000000000000########000000000000####0000000000000000000000000000000000000000####
####00000000000000000000000000000000000000000000000000000000########000000000000####0000000000000000000000000000000000000000####
####00000000000000000000000000000000000000000000000000000000########000000000000####0000000000000000000000000000000000000000####
################################################################################################################################
################################################################################################################################
################################################################################################################################
################################################################################################################################

